50,50,
2,3,4,5,3,5,6,8,8,8,9,9,9,9,9,9,9,7,5,7,7,9,9,9,9,9,9,10,10,10,10,8,6,4,2,4,5,7,6,4,6,6,8,10,11,11,9,7,5,3,
3,2,3,3,3,4,5,6,7,7,7,8,8,8,8,8,7,7,6,6,7,7,8,8,8,8,8,8,8,8,8,7,5,4,3,3,4,5,5,5,5,6,7,8,8,8,8,6,5,4,
4,3,3,3,3,4,5,6,7,7,7,7,8,8,8,8,7,7,6,6,7,7,7,8,8,8,8,8,8,8,8,7,6,4,3,3,4,5,5,5,5,6,7,8,8,8,8,7,5,5,
4,4,4,4,4,5,6,7,7,8,8,8,8,8,8,8,8,7,7,7,7,8,8,8,8,8,8,8,8,8,8,8,6,5,4,4,5,5,6,6,6,6,7,8,8,8,8,7,6,5,
6,5,5,5,5,6,7,8,8,8,8,8,8,8,8,8,8,8,8,8,8,8,8,8,8,8,8,9,9,9,9,8,7,6,5,5,6,6,6,6,6,7,8,8,9,9,8,8,7,7,
7,6,6,6,6,7,8,8,8,8,8,8,8,8,8,8,8,8,8,8,8,8,8,8,9,9,9,10,10,10,10,9,8,7,6,6,7,7,7,7,7,8,8,9,10,10,9,8,8,8,
8,7,7,7,7,7,8,8,8,9,9,9,9,9,9,9,9,8,8,8,8,9,9,9,9,10,10,11,11,11,10,9,8,7,7,7,7,7,7,7,8,8,9,10,11,11,10,8,8,9,
8,7,7,7,7,7,8,8,8,9,10,10,10,10,10,10,9,8,8,8,8,9,10,10,10,10,11,11,11,11,10,9,8,7,7,7,7,7,7,8,8,8,9,10,11,11,10,9,8,9,
8,7,7,7,7,7,8,8,8,9,10,10,10,10,10,10,9,8,8,8,8,9,10,10,10,10,11,11,11,11,10,9,8,7,7,7,7,7,8,8,8,8,9,10,11,11,10,9,8,9,
8,7,7,7,7,7,8,8,8,9,10,10,10,10,10,10,9,8,8,8,8,9,10,10,10,10,11,11,11,11,10,9,8,7,7,7,7,7,7,7,8,8,9,10,11,11,10,8,8,9,
8,7,7,7,7,7,8,8,8,9,9,10,10,10,10,9,9,8,8,8,8,9,9,10,10,10,10,11,11,11,10,9,8,7,7,7,7,7,7,7,7,8,9,10,11,11,10,8,8,9,
6,7,7,7,7,7,8,8,8,9,10,10,10,10,10,10,9,8,8,8,8,9,10,10,10,10,11,11,11,11,10,9,8,7,7,7,7,7,7,7,8,8,9,10,11,11,10,8,8,7,
8,7,7,7,7,8,8,8,9,10,10,11,11,11,11,11,10,9,8,8,9,10,10,11,11,11,11,12,12,12,11,10,8,8,7,7,7,8,8,8,8,8,9,11,12,12,11,9,8,9,
9,7,7,7,7,8,8,9,10,10,11,11,11,11,11,11,10,9,9,9,9,10,11,11,11,12,12,12,13,13,12,10,9,8,7,7,8,8,8,8,8,9,10,11,12,12,11,10,8,10,
9,8,7,7,7,8,8,9,10,11,11,11,11,11,11,11,10,9,9,9,9,10,11,11,12,12,12,13,13,13,12,11,9,8,7,7,8,8,8,8,8,9,10,12,13,13,12,10,9,10,
9,8,7,7,7,8,8,9,10,11,11,11,11,11,11,11,10,9,9,9,9,10,11,12,12,12,13,13,13,13,12,11,9,8,7,7,8,8,8,8,8,9,10,12,13,13,12,10,9,10,
9,8,7,7,7,8,8,9,10,11,11,11,11,11,11,11,10,9,9,9,9,10,11,12,12,12,13,13,13,13,12,11,9,8,7,7,8,8,8,8,8,9,10,12,13,13,12,10,9,10,
9,8,7,7,7,8,8,9,10,11,11,11,11,11,11,11,10,9,9,9,9,10,11,12,12,12,13,13,13,13,12,11,9,8,7,7,8,8,8,8,8,9,10,12,13,13,12,10,9,10,
9,8,7,7,7,8,8,9,10,11,11,11,11,11,11,11,10,9,8,8,9,10,11,11,11,12,12,13,13,13,12,10,8,8,7,7,8,8,8,8,8,8,10,12,13,13,12,10,9,10,
9,7,7,7,7,7,8,8,9,10,10,10,10,10,10,10,9,8,8,8,8,9,10,10,10,11,11,11,12,12,11,9,8,7,7,7,7,7,7,7,8,8,9,11,12,12,11,9,8,10,
7,6,5,5,5,6,7,8,8,8,8,8,8,8,8,8,8,8,8,8,8,8,8,8,8,9,9,10,10,10,9,8,7,6,6,6,6,6,6,6,7,8,8,9,10,10,9,8,7,8,
5,4,4,4,4,5,6,7,7,7,8,8,8,8,8,8,8,7,7,7,7,8,8,8,8,8,8,8,8,8,8,8,6,5,4,4,5,5,6,6,6,7,8,8,8,8,8,7,6,6,
3,4,4,4,4,5,6,7,7,7,8,8,8,8,8,8,8,7,7,7,7,7,8,8,8,8,8,8,8,8,8,7,6,5,4,4,5,6,6,6,6,7,8,8,8,8,8,7,6,4,
5,4,4,4,5,6,6,7,8,8,8,8,8,8,8,8,8,8,7,7,8,8,8,8,8,8,8,8,8,8,8,8,7,5,5,5,6,6,6,6,7,7,8,8,9,9,8,7,6,6,
6,5,5,5,6,6,7,8,8,8,8,8,8,8,8,8,8,8,8,8,8,8,8,8,8,8,9,9,9,9,9,8,7,6,6,6,6,6,6,6,7,8,8,9,10,10,9,8,7,7,
8,6,6,6,6,6,7,8,8,8,8,8,8,8,8,8,8,8,8,8,8,8,8,8,8,8,9,9,9,9,9,8,7,6,6,6,6,6,6,6,7,8,8,9,10,10,9,8,7,9,
7,6,6,6,6,6,7,8,8,8,8,8,8,8,8,8,8,8,8,8,8,8,8,8,8,8,9,9,9,9,8,8,7,6,6,6,6,6,6,6,7,8,8,9,9,9,8,8,7,8,
5,6,6,6,6,7,7,8,8,8,8,8,8,8,8,8,8,8,8,8,8,8,8,8,8,9,9,10,10,10,9,8,7,7,6,6,6,7,7,7,7,8,8,9,10,10,9,8,7,6,
7,6,6,6,7,7,8,8,9,9,9,9,9,9,9,9,9,8,8,8,8,9,9,9,9,10,10,11,11,11,10,9,8,7,7,7,7,8,8,8,8,8,9,10,11,11,10,8,8,8,
9,7,7,7,7,8,8,9,10,10,10,10,10,10,10,10,10,9,8,8,9,10,10,10,10,11,11,12,12,12,11,10,8,8,7,7,8,8,8,8,8,9,10,11,12,12,11,10,8,10,
9,8,8,8,8,8,9,10,11,11,11,11,11,11,11,11,11,10,9,9,10,11,11,11,12,12,12,13,13,13,12,11,9,8,8,8,8,8,8,8,8,9,11,12,13,13,12,10,9,10,
10,8,8,8,8,8,9,10,11,12,12,12,12,12,12,12,12,11,10,10,10,11,12,12,12,13,13,14,14,14,13,12,10,8,8,8,8,8,8,8,8,9,11,13,14,14,13,11,10,11,
10,8,8,8,8,8,9,10,11,12,12,12,12,12,12,12,12,11,10,10,11,11,12,12,12,13,13,14,14,14,13,12,10,8,8,8,8,8,8,8,8,9,11,13,14,14,13,11,10,11,
10,8,8,8,8,8,8,9,10,11,11,11,11,11,11,11,11,10,9,9,10,11,11,11,12,12,12,13,13,13,12,11,9,8,7,7,8,8,8,8,8,8,10,12,13,13,12,10,9,11,
8,7,7,7,7,7,8,8,8,9,9,10,10,10,10,10,9,8,8,8,8,9,10,10,10,10,11,11,11,11,10,9,8,7,6,6,7,7,7,7,8,8,8,10,11,11,10,9,8,9,
6,5,5,5,5,5,6,7,8,8,8,8,8,8,8,8,8,7,7,7,8,8,8,8,8,8,8,9,9,9,8,8,7,6,5,5,5,6,6,6,6,7,8,8,9,9,8,8,7,7,
4,3,3,3,3,4,5,6,7,7,7,7,7,7,7,7,7,7,6,6,7,7,7,7,7,7,8,8,8,8,8,7,6,4,3,3,4,5,5,5,5,6,7,8,8,8,8,7,5,5,
2,3,2,2,3,4,5,6,7,7,7,7,7,7,7,7,7,7,6,6,7,7,7,7,7,7,7,8,8,8,8,7,5,4,3,3,4,4,4,4,5,6,7,8,8,8,8,6,5,3,
4,3,3,3,3,4,5,6,7,7,7,7,7,7,7,7,7,7,7,7,7,7,7,7,7,7,8,8,8,8,8,7,6,4,3,3,4,4,4,5,5,6,7,8,8,8,8,7,5,5,
5,4,4,4,4,5,6,7,7,7,8,8,8,8,8,8,7,7,7,7,7,7,8,8,8,8,8,8,8,8,8,7,6,5,4,4,4,5,5,5,6,6,7,8,8,8,8,7,6,6,
5,5,5,5,5,6,7,7,8,8,8,8,8,8,8,8,8,7,7,7,7,8,8,8,8,8,8,8,8,8,8,8,7,6,5,5,5,6,6,6,6,7,8,8,9,9,8,8,7,6,
7,5,5,5,5,6,7,7,8,8,8,8,8,8,8,8,8,7,7,7,7,8,8,8,8,8,8,8,8,8,8,8,7,6,5,5,6,6,6,6,6,7,8,8,8,8,8,8,7,8,
6,5,5,5,5,6,6,7,7,8,8,8,8,8,8,8,8,7,7,7,7,8,8,8,8,8,8,8,8,8,8,8,7,5,5,5,6,6,6,6,6,7,8,8,8,8,8,7,6,7,
4,5,5,5,5,6,7,7,8,8,8,8,8,8,8,8,8,8,7,7,8,8,8,8,8,8,8,8,8,8,8,8,7,6,5,5,6,6,6,6,6,7,8,8,9,9,8,7,6,5,
6,6,6,6,6,6,7,8,8,8,9,9,9,9,9,9,8,8,8,8,8,8,9,9,9,9,9,9,10,10,9,8,8,7,6,6,6,7,7,7,7,8,8,9,10,10,9,8,7,7,
8,7,7,7,7,7,8,8,8,9,9,10,10,10,10,10,9,8,8,8,8,9,9,10,10,10,10,11,11,11,10,9,8,7,7,7,7,7,7,7,8,8,9,10,11,11,10,8,8,9,
9,7,7,7,7,7,8,8,8,8,9,9,9,9,9,9,9,8,8,8,8,9,9,9,9,10,10,11,11,11,10,9,8,7,7,7,7,7,7,7,8,8,9,10,11,11,10,8,8,10,
7,6,5,5,5,6,7,7,8,8,8,8,8,8,8,8,8,8,8,8,8,8,8,8,8,8,9,9,10,10,9,8,7,6,6,6,6,6,6,6,7,8,8,9,10,10,9,8,7,8,
5,4,4,4,4,5,6,7,7,8,8,8,8,8,8,8,8,7,7,7,8,8,8,8,8,8,8,8,9,9,8,8,6,5,4,4,5,6,6,6,6,7,8,8,9,9,8,7,6,6,
3,4,5,6,4,6,7,9,9,9,10,10,10,10,10,10,10,8,6,8,8,10,10,10,10,10,10,11,11,11,11,9,7,5,3,5,6,8,7,5,7,7,9,11,12,12,10,8,6,4,
